WWWWWWWWWWWWWWWWWWWWWWWWWWWWWWWWWWWWWWWWWW
WWWWWWWWWWWWWWWWWWWWWWWWWWWWWWWWWWWWWWWWWW
WW                  WW                  WW
WW                  WW                  WW
WW  WWWWWW  WWWWWW  WW  WWWWWW  WWWWWW  WW
WW  WWWWWW  WWWWWW  WW  WWWWWW  WWWWWW  WW
WW                                      WW
WW                                      WW
WW  WWWWWW  WW  WWWWWWWWWW  WW  WWWWWW  WW
WW  WWWWWW  WW  WWWWWWWWWW  WW  WWWWWW  WW
WW          WW      WW      WW          WW
WW          WW      WW      WW          WW
WWWWWWWWWW  WWWWWW  WW  WWWWWW  WWWWWWWWWW
WWWWWWWWWW  WWWWWW  WW  WWWWWW  WWWWWWWWWW
WWWWWWWWWW  WW              WW  WWWWWWWWWW
WWWWWWWWWW  WW              WW  WWWWWWWWWW
WWWWWWWWWW  WW  WWWW  WWWW  WW  WWWWWWWWWW
WWWWWWWWWW  WW  WWWW  WWWW  WW  WWWWWWWWWW
                WW      WW
                WW      WW
WWWWWWWWWW  WW  WWWWWWWWWW  WW  WWWWWWWWWW
WWWWWWWWWW  WW  WWWWWWWWWW  WW  WWWWWWWWWW
WWWWWWWWWW  WW              WW  WWWWWWWWWW
WWWWWWWWWW  WW              WW  WWWWWWWWWW
WWWWWWWWWW  WW  WWWWWWWWWW  WW  WWWWWWWWWW
WWWWWWWWWW  WW  WWWWWWWWWW  WW  WWWWWWWWWW
WW                  WW                  WW
WW                  WW                  WW
WW  WWWWWW  WWWWWW  WW  WWWWWW  WWWWWW  WW
WW  WWWWWW  WWWWWW  WW  WWWWWW  WWWWWW  WW
WW      WW                      WW      WW
WW      WW                      WW      WW
WWWWWW  WW  WW  WWWWWWWWWW  WW  WW  WWWWWW
WWWWWW  WW  WW  WWWWWWWWWW  WW  WW  WWWWWW
WW          WW      WW      WW          WW
WW          WW      WW      WW          WW
WW  WWWWWWWWWWWWWW  WW  WWWWWWWWWWWWWW  WW
WW  WWWWWWWWWWWWWW  WW  WWWWWWWWWWWWWW  WW
WW                                      WW
WW                                      WW
WWWWWWWWWWWWWWWWWWWWWWWWWWWWWWWWWWWWWWWWWW
WWWWWWWWWWWWWWWWWWWWWWWWWWWWWWWWWWWWWWWWWW