WWWWWWWWWWWWWWWWWWWWWWWWWWWWWWWWWWWWWWWWWW
WWWWWWWWWWWWWWWWWWWWWWWWWWWWWWWWWWWWWWWWWW
WW G                WW                G WW
WW PPPPPPPPPPPPPPPPPWW PPPPPPPPPPPPPPPPPWW
WW PWWWWWW PWWWWWW PWW PWWWWWW PWWWWWW PWW
WW PWWWWWW PWWWWWW PWW PWWWWWW PWWWWWW PWW
WW P       P       P   P       P       PWW
WW PPPPPPPPPPPPPPPPPPPPPPPPPPPPPPPPPPPPPWW
WW PWWWWWW PWW PWWWWWWWWWW PWW PWWWWWW PWW
WW PWWWWWW PWW PWWWWWWWWWW PWW PWWWWWW PWW
WW P       PWW P    WW     PWW P       PWW
WW PPPPPPPPPWW PPPPPWW PPPPPWW PPPPPPPPPWW
WWWWWWWWWW PWWWWWW PWW PWWWWWW PWWWWWWWWWW
WWWWWWWWWW PWWWWWW PWW PWWWWWW PWWWWWWWWWW
WWWWWWWWWW PWW     P   P    WW PWWWWWWWWWW
WWWWWWWWWW PWW PPPPPPPPPPPPPWW PWWWWWWWWWW
WWWWWWWWWW PWW PWWWW  WWWW PWW PWWWWWWWWWW
WWWWWWWWWW PWW PWWWW  WWWW PWW PWWWWWWWWWW
T          P   PWW      WW P   P         T
           PPPPPWW      WW PPPPP
WWWWWWWWWW PWW PWWWWWWWWWW PWW PWWWWWWWWWW
WWWWWWWWWW PWW PWWWWWWWWWW PWW PWWWWWWWWWW
WWWWWWWWWW PWW P           PWW PWWWWWWWWWW
WWWWWWWWWW PWW PPPPPPPPPPPPPWW PWWWWWWWWWW
WWWWWWWWWW PWW PWWWWWWWWWW PWW PWWWWWWWWWW
WWWWWWWWWW PWW PWWWWWWWWWW PWW PWWWWWWWWWW
WW         P   P    WW     P   P        WW
WW PPPPPPPPPPPPPPPPPWW PPPPPPPPPPPPPPPPPWW
WW PWWWWWW PWWWWWW PWW PWWWWWW PWWWWWW PWW
WW PWWWWWW PWWWWWW PWW PWWWWWW PWWWWWW PWW
WW P    WW P       P   P       PWW     PWW
WW PPPPPWW PPPPPPPPPPPPPPPPPPPPPWW PPPPPWW
WWWWWW PWW PWW PWWWWWWWWWW PWW PWW PWWWWWW
WWWWWW PWW PWW PWWWWWWWWWW PWW PWW PWWWWWW
WW     P   PWW P    WW     PWW P   P    WW
WW PPPPPPPPPWW PPPPPWW PPPPPWW PPPPPPPPPWW
WW PWWWWWWWWWWWWWW PWW PWWWWWWWWWWWWWW PWW
WW PWWWWWWWWWWWWWW PWW PWWWWWWWWWWWWWW PWW
WW PG              P   P            G  PWW
WW PPPPPPPPPPPPPPPPPPPPPPPPPPPPPPPPPPPPPWW
WWWWWWWWWWWWWWWWWWWWWWWWWWWWWWWWWWWWWWWWWW
WWWWWWWWWWWWWWWWWWWWWWWWWWWWWWWWWWWWWWWWWW